R 1366 768 
NO config/texture1.xpm                        
SO config/texture2.xpm
WE config/texture3.xpm
EA config/texture4.xpm                                                           
S  config/sprite.xpm         
F  123,132,123               
C  56,89,223

MAP
11111111111111111111111111111
10000000000000000000000000001
10000000000000000000000000001
100000000000000W0000000000001                
10000000000000000000000000001
10000000001100000111011110001 
11110111111111011101001010001
11110111111111011101001010001
11000000110101011100000010001
10000000000000001100000010001
10000000000000001101010010001
11000000110101011111011110001
11110111111101011111011110001
11111111111111111111111111111